6 # # # 5 2 # 8 3
# # 8 # 3 7 5 # #
2 # # # # # # 4 1
8 3 # 4 # 7 # # 6
# # 6 # # # 3 # #
7 # 4 9 # 1 # 6 4
# # # 8 6 # # 7 #
# # 2 # 4 # 6 # #
# 4 # 5 7 # 2 2 #