9 6 1 1 7 4 3 5 8
1 7 8 3 2 5 6 4 9
2 5 4 6 8 9 7 3 1
8 2 5 4 3 7 1 9 6
4 9 6 8 5 2 3 1 7
7 1 3 9 6 1 8 2 4
5 3 9 7 1 8 4 6 2
6 8 7 2 4 6 9 1 3
3 4 2 5 9 8 6 7 1